1804289383,JEAN-MICHEL DARMANGEAT,20230730,1
846930886,CHRISTOPHE ONGAGNA,20230730,3
1681692777,OLIVIER LERY,20230730,1
1714636915,JEAN-MICHEL LABONNE,20230730,1
1957747793,BRYAN CHANGEUX,20230730,3
1649760492,EMMANUEL DE LAS CASES,20230730,1
1025202362,ARMAND-JEAN DU PLESSIS DE RICHELIEU,20230730,1
1914544919,MATTHIEU LEBON,20230730,3
608413784,BERNARD VILLON,20230730,2
424238335,MICHELE MARTIN,20230730,3
